11111111111111111111111111111
10000000001000000000000000001
100000000010000000P0000000001
10000000000000000010000000001
100000000010000001C1000000001
1E000000001000000000000000001
11111111111111111111111111111