11111111111111111111111111111
1000E000001000000000000000001
1000C000001000000000000000001
1000000000000000000P000000001
10000000001000000000000000001
10000000001000000000000000001
11111111111111111111111111111
